You wake up to the sound of birds chirping outside your window. It's a peaceful morning in Clearhollow.

Lab 1
An Interactive Fiction by Cooper Mattern
Release 1 / Serial number 250420 / Inform 7 build 6M62 (I6/v6.33 lib 6/12N) SD

My House (on My Bed)
Your home is modest but comfortable, with a bed and a small table.

You can see a House Door here.

From here, you can go:
    north through the House Door.

>l
My House (on My Bed)
You can see a House Door here.

From here, you can go:
    north through the House Door.

>n
North Village Road

>n
If your goat went in there, it's long gone. Lets keep looking around the village.

>s
Village Centre

>n
North Village Road

>e
Wheat Field

>e
You dont feel like going for a swim today.

>s
Fishing House

>e
You can't go that way.

>s
East Village Road

>e
You dont feel like going for a swim today.

* * *

>l
My House (on My Bed)
You can see a House Door here.

From here, you can go:
    north through the House Door.

>o door
Sorry, that can't be corrected.

>open door
You'll need to get off My Bed first.

>get off
You'll need to get off My Bed first.

* * *

You wake up to the sound of birds chirping outside your window. It's a peaceful morning in Clearhollow.

Lab 1
An Interactive Fiction by Cooper Mattern
Release 1 / Serial number 250420 / Inform 7 build 6M62 (I6/v6.33 lib 6/12N) SD

My House (on My Bed)
Your home is modest but comfortable, with a bed and a small table.

You can see a House Door here.

From here, you can go:
    north through the House Door.

>n
You climb down from My Bed.

As you step outside, you notice your prized goat is missing from the pen. Determined to find it, you set off to investigate.

(first opening the House Door)

My Yard
The yard is fenced in, with a path leading to the goat pen.

A sturdy leather leash lies coiled on the ground.

You can also see a House Door, a Pen Door and a Yard Door here.

From here, you can go:
    north through the Yard Door.
    south through the open House Door to My House.
    west through the Pen Door.

Joseph is idle 
Hope is idle 
yourself is idle 
Melia is idle 
character: Melia
    movement path:North Village Centre, Village Centre, West Village Centre, Tavern Stable, The Common Area and Taproom
Melia is moving 
    movement path:North Village Centre, Village Centre, West Village Centre, Tavern Stable, The Common Area and Taproom
    moving Melia from Melia and Tom's House to North Village Centre
    number of entries: 5
Tom is idle 
Goat is idle 
Allen is idle 

7:05 am

>n
(first opening the Yard Door)

West Village Centre
You can see a Yard Door here.

From here, you can go:
     north to Tavern Stable.
    south through the open Yard Door to My Yard.
     east to Village Centre.
     west to West Forest.

>e
Village Centre
From here, you can go:
     north to North Village Centre.
     south to South Village Centre.
     east to East Village Centre.
     west to West Village Centre.

>e
East Village Centre
You can see Joseph and Hope's House's Door here.

From here, you can go:
     north to Fishing House.
    south through Joseph and Hope's House's Door.
     east to Lake.
     west to Village Centre.

>e
You dont feel like going for a swim today. Let's focus on finding our goat.

>n
Fishing House
From here, you can go:
     north to Wheat Field.
     south to East Village Centre.

>n
Wheat Field
From here, you can go:
     north to North Forest.
     south to Fishing House.
     east to Lake.
     west to North Village Centre.

>n
If your goat went in there, it's long gone. Let's keep looking around the village.

>w
North Village Centre
You can see Melia and Tom's House's Door here.

From here, you can go:
     north to North Forest.
     south to Village Centre.
     east to Wheat Field.
    west through Melia and Tom's House's Door.

>n
If your goat went in there, it's long gone. Let's keep looking around the village.

>s
Village Centre
From here, you can go:
     north to North Village Centre.
     south to South Village Centre.
     east to East Village Centre.
     west to West Village Centre.

>w
West Village Centre
You can see a Yard Door here.

From here, you can go:
     north to Tavern Stable.
    south through the open Yard Door to My Yard.
     east to Village Centre.
     west to West Forest.

>n
Tavern Stable
You can see a Tavern Door here.

From here, you can go:
     south to West Village Centre.
    west through the Tavern Door.

>w
(first opening the Tavern Door)

The Common Area
You can see a Lodge Door, a Tavern Door and a Tavern Back Door here.

From here, you can go:
    north through the Tavern Back Door.
    south through the Lodge Door.
    east through the open Tavern Door to Tavern Stable.
     west to Taproom.

>n
If your goat went in there, it's long gone. Let's keep looking around the village.

>look
The Common Area
You can see a Lodge Door, a Tavern Door and a Tavern Back Door here.

From here, you can go:
    north through the Tavern Back Door.
    south through the Lodge Door.
    east through the open Tavern Door to Tavern Stable.
     west to Taproom.

>open tavern Back Door
You open the Tavern Back Door.

>ls
That's not a verb I recognise.

>look
The Common Area
You can see a Lodge Door, a Tavern Door and a Tavern Back Door here.

From here, you can go:
    north through the open Tavern Back Door to North Forest.
    south through the Lodge Door.
    east through the open Tavern Door to Tavern Stable.
     west to Taproom.

* * *

>e
Village Centre
From here, you can go:
 north to North Village Centre.
 south to South Village Centre.
 east to East Village Centre.
 west to West Village Centre.

>e
East Village Centre
From here, you can go:
 north to Fishing House.
 south to Joseph and Hope's House.
 east to Lake.
 west to Village Centre.

>e
You dont feel like going for a swim today.

* * *

>take all
Leash: Taken.

Joseph is idle 
Hope is idle 
yourself is idle 
Melia is moving 
    movement path:Village Centre, West Village Centre, Tavern Stable, The Common Area and Taproom
    moving Melia from North Village Centre to Village Centre
    number of entries: 4
Tom is idle 
Goat is idle 
Allen is idle 

7:10 am

>look
My Yard
The yard is fenced in, with a path leading to the goat pen.

You can see a House Door, a Pen Door and a Yard Door here.

From here, you can go:
    north through the Yard Door.
    south through the open House Door to My House.
    west through the Pen Door.

Joseph is idle 
Hope is idle 
yourself is idle 
Melia is moving 
    movement path:West Village Centre, Tavern Stable, The Common Area and Taproom
    moving Melia from Village Centre to West Village Centre
    number of entries: 3
Tom is idle 
Goat is idle 
Allen is idle 

7:15 am

>n
(first opening the Yard Door)

West Village Centre
The western part of the village feels more rustic, with dirt paths and wooden fences.

You can see a Yard Door and Melia here.

From here, you can go:
    north to Tavern Stable.
    south through the open Yard Door to My Yard.
    east to Village Centre.
    west to The West Forest.

Joseph is idle 
Hope is idle 
yourself is idle 
Melia is moving 
    movement path:Tavern Stable, The Common Area and Taproom
    moving Melia from West Village Centre to Tavern Stable
    number of entries: 2
Tom is idle 
Goat is idle 
Allen is idle 

7:20 am

>n
Tavern Stable
The stable smells of hay and animals. It's where villagers keep their livestock temporarily.

You can see a Tavern Door and Melia here.

From here, you can go:
    south to West Village Centre.
    west through the Tavern Door.

Joseph is idle 
Hope is idle 
yourself is idle 
Melia is moving 
    movement path:The Common Area and Taproom
    moving Melia from Tavern Stable to The Common Area
    number of entries: 1
Tom is idle 
Goat is idle 
Allen is idle 

7:25 am

>w
(first opening the Tavern Door)

The Common Area
The tavern's main area, filled with tables and chairs. Villagers gather here to eat and talk.

You can see a Lodge Door, a Tavern Door, Melia and a Tavern Back Door here.

From here, you can go:
    north through the Tavern Back Door.
    south through the Lodge Door.
    east through the open Tavern Door to Tavern Stable.
    west to Taproom.

Joseph is idle 
Hope is idle 
yourself is idle 
Melia is moving 
    movement path:Taproom
    moving Melia from The Common Area to Taproom
    number of entries: 0
Tom is idle 
Goat is idle 
Allen is idle 

7:30 am

>w
Taproom
The taproom is lively, with the sound of mugs clinking and laughter echoing.

You can see Melia here.

From here, you can go:
    east to The Common Area.

Joseph is idle 
Hope is idle 
yourself is idle 
Melia is idle 
Tom is idle 
Goat is idle 
Allen is idle 

7:35 am

>w
You can't go that way.

Joseph is idle 
Hope is idle 
yourself is idle 
Melia is idle 
Tom is idle 
Goat is idle 
Allen is idle 

7:40 am

>e
The Common Area
The tavern's main area, filled with tables and chairs. Villagers gather here to eat and talk.

You can see a Lodge Door, a Tavern Door and a Tavern Back Door here.

From here, you can go:
    north through the Tavern Back Door.
    south through the Lodge Door.
    east through the open Tavern Door to Tavern Stable.
    west to Taproom.

Joseph is idle 
Hope is idle 
yourself is idle 
Melia is idle 
Tom is idle 
Goat is idle 
Allen is idle 

7:45 am

>wait
Time passes.

Joseph is idle 
Hope is idle 
yourself is idle 
Melia is idle 
Tom is idle 
Goat is idle 
Allen is idle 

7:50 am

>again
Time passes.

Joseph is idle 
Hope is idle 
yourself is idle 
Melia is idle 
Tom is idle 
Goat is idle 
Allen is idle 

7:55 am

>again
Time passes.

Joseph is idle 
Hope is idle 
yourself is idle 
Melia is idle 
Tom is idle 
Goat is idle 
Allen is idle 

8:00 am
You hear the breakfast bell ringing. Everyone in the village goes to the tavern across from your house for breakfast.

>again
Time passes.

Joseph is idle 
character: Joseph
    movement path:East Village Centre, Village Centre, West Village Centre, Tavern Stable and The Common Area
Joseph is moving 
    movement path:East Village Centre, Village Centre, West Village Centre, Tavern Stable and The Common Area
    moving Joseph from Joseph and Hope's House to East Village Centre
    number of entries: 4
Hope is idle 
character: Hope
    movement path:East Village Centre, Village Centre, West Village Centre, Tavern Stable and The Common Area
Hope is moving 
    movement path:East Village Centre, Village Centre, West Village Centre, Tavern Stable and The Common Area
    moving Hope from Joseph and Hope's House to East Village Centre
    number of entries: 4
yourself is idle 
Melia is idle 
Tom is idle 
character: Tom
    movement path:North Village Centre, Village Centre, West Village Centre, Tavern Stable and The Common Area
Tom is moving 
    movement path:North Village Centre, Village Centre, West Village Centre, Tavern Stable and The Common Area
    moving Tom from Melia and Tom's House to North Village Centre
    number of entries: 4
Goat is idle 
Allen is idle 
character: Allen
    movement path:South Village Centre, Village Centre, West Village Centre, Tavern Stable and The Common Area
Allen is moving 
    movement path:South Village Centre, Village Centre, West Village Centre, Tavern Stable and The Common Area
    moving Allen from Allen's House to South Village Centre
    number of entries: 4

8:05 am

>again
Time passes.

Joseph is moving 
    movement path:Village Centre, West Village Centre, Tavern Stable and The Common Area
    moving Joseph from East Village Centre to Village Centre
    number of entries: 3
Hope is moving 
    movement path:Village Centre, West Village Centre, Tavern Stable and The Common Area
    moving Hope from East Village Centre to Village Centre
    number of entries: 3
yourself is idle 
Melia is idle 
Tom is moving 
    movement path:Village Centre, West Village Centre, Tavern Stable and The Common Area
    moving Tom from North Village Centre to Village Centre
    number of entries: 3
Goat is idle 
Allen is moving 
    movement path:Village Centre, West Village Centre, Tavern Stable and The Common Area
    moving Allen from South Village Centre to Village Centre
    number of entries: 3

8:10 am

>again
Time passes.

Joseph is moving 
    movement path:West Village Centre, Tavern Stable and The Common Area
    moving Joseph from Village Centre to West Village Centre
    number of entries: 2
Hope is moving 
    movement path:West Village Centre, Tavern Stable and The Common Area
    moving Hope from Village Centre to West Village Centre
    number of entries: 2
yourself is idle 
Melia is idle 
Tom is moving 
    movement path:West Village Centre, Tavern Stable and The Common Area
    moving Tom from Village Centre to West Village Centre
    number of entries: 2
Goat is idle 
Allen is moving 
    movement path:West Village Centre, Tavern Stable and The Common Area
    moving Allen from Village Centre to West Village Centre
    number of entries: 2

8:15 am

>again
Time passes.

Joseph is moving 
    movement path:Tavern Stable and The Common Area
    moving Joseph from West Village Centre to Tavern Stable
    number of entries: 1
Hope is moving 
    movement path:Tavern Stable and The Common Area
    moving Hope from West Village Centre to Tavern Stable
    number of entries: 1
yourself is idle 
Melia is idle 
Tom is moving 
    movement path:Tavern Stable and The Common Area
    moving Tom from West Village Centre to Tavern Stable
    number of entries: 1
Goat is idle 
Allen is moving 
    movement path:Tavern Stable and The Common Area
    moving Allen from West Village Centre to Tavern Stable
    number of entries: 1

8:20 am

>again
Time passes.

Joseph is moving 
    movement path:The Common Area
    moving Joseph from Tavern Stable to The Common Area
    number of entries: 0
Hope is moving 
    movement path:The Common Area
    moving Hope from Tavern Stable to The Common Area
    number of entries: 0
yourself is idle 
Melia is idle 
Tom is moving 
    movement path:The Common Area
    moving Tom from Tavern Stable to The Common Area
    number of entries: 0
Goat is idle 
Allen is moving 
    movement path:The Common Area
    moving Allen from Tavern Stable to The Common Area
    number of entries: 0

8:25 am

>again
Time passes.

Joseph is idle 
Hope is idle 
yourself is idle 
Melia is idle 
Tom is idle 
Goat is idle 
Allen is idle 

8:30 am

>look
The Common Area
The tavern's main area, filled with tables and chairs. Villagers gather here to eat and talk.

You can see Allen, Tom, Hope, Joseph, a Lodge Door, a Tavern Door and a Tavern Back Door here.

From here, you can go:
    north through the Tavern Back Door.
    south through the Lodge Door.
    east through the open Tavern Door to Tavern Stable.
    west to Taproom.

Joseph is idle 
Hope is idle 
yourself is idle 
Melia is idle 
Tom is idle 
Goat is idle 
Allen is idle 

8:35 am

>talk to allen about the goat
That's not a verb I recognise.

>ask allen about the goat
There is no reply.

Joseph is idle 
Hope is idle 
yourself is idle 
Melia is idle 
Tom is idle 
Goat is idle 
Allen is idle 

8:40 am

>ask allen about goat
I haven't heard anything about your goat," Allen says curtly.
Joseph is idle 
Hope is idle 
yourself is idle 
Melia is idle 
Tom is idle 
Goat is idle 
Allen is idle 

8:45 am

>ask joseph about goat
I haven't heard anything about your goat, maybe someone else knows something.
Joseph is idle 
Hope is idle 
yourself is idle 
Melia is idle 
Tom is idle 
Goat is idle 
Allen is idle 

8:50 am

>ask hope about goat
I haven't heard anything about your goat, Hope says. "Sorry I can't help."
Joseph is idle 
Hope is idle 
yourself is idle 
Melia is idle 
Tom is idle 
Goat is idle 
Allen is idle 

8:55 am

>tell tom about goat
I haven't heard anything about your goat," Tom says. "I'll let you know if I find anything."
Joseph is idle 
Hope is idle 
yourself is idle 
Melia is idle 
Tom is idle 
Goat is idle 
Allen is idle 

9:00 am

>wait
Time passes.

Joseph is idle 
character: Joseph
    movement path:Tavern Stable, West Village Centre, Village Centre, East Village Centre and Fishing House
Joseph is moving 
    movement path:Tavern Stable, West Village Centre, Village Centre, East Village Centre and Fishing House
    moving Joseph from The Common Area to Tavern Stable
    number of entries: 4
Hope is idle 
character: Hope
    movement path:Tavern Stable, West Village Centre, Village Centre, South Village Centre and The Common Shelf
Hope is moving 
    movement path:Tavern Stable, West Village Centre, Village Centre, South Village Centre and The Common Shelf
    moving Hope from The Common Area to Tavern Stable
    number of entries: 4
yourself is idle 
Melia is idle 
Tom is idle 
character: Tom
    movement path:Tavern Stable, West Village Centre, Village Centre, North Village Centre and Wheat Field
Tom is moving 
    movement path:Tavern Stable, West Village Centre, Village Centre, North Village Centre and Wheat Field
Tom pauses and says, "I'm heading to the Wheat Field, but I can spare a moment to talk."
Goat is idle 
Allen is idle 
character: Allen
    movement path:Tavern Stable, West Village Centre, Village Centre, South Village Centre and The South Forest
Allen is moving 
    movement path:Tavern Stable, West Village Centre, Village Centre, South Village Centre and The South Forest
    moving Allen from The Common Area to Tavern Stable
    number of entries: 4

9:05 am

>tell tom about goat
I haven't heard anything about your goat," Tom says. "I'll let you know if I find anything."
Joseph is moving 
    movement path:West Village Centre, Village Centre, East Village Centre and Fishing House
    moving Joseph from Tavern Stable to West Village Centre
    number of entries: 3
Hope is moving 
    movement path:West Village Centre, Village Centre, South Village Centre and The Common Shelf
    moving Hope from Tavern Stable to West Village Centre
    number of entries: 3
yourself is idle 
Melia is idle 
Tom is moving 
    movement path:Tavern Stable, West Village Centre, Village Centre, North Village Centre and Wheat Field
Tom pauses and says, "I'm heading to the Wheat Field, but I can spare a moment to talk."
Goat is idle 
Allen is moving 
    movement path:West Village Centre, Village Centre, South Village Centre and The South Forest
    moving Allen from Tavern Stable to West Village Centre
    number of entries: 3

9:10 am

>wait
Time passes.

Joseph is moving 
    movement path:Village Centre, East Village Centre and Fishing House
    moving Joseph from West Village Centre to Village Centre
    number of entries: 2
Hope is moving 
    movement path:Village Centre, South Village Centre and The Common Shelf
    moving Hope from West Village Centre to Village Centre
    number of entries: 2
yourself is idle 
Melia is idle 
Tom is moving 
    movement path:Tavern Stable, West Village Centre, Village Centre, North Village Centre and Wheat Field
Tom pauses and says, "I'm heading to the Wheat Field, but I can spare a moment to talk."
Goat is idle 
Allen is moving 
    movement path:Village Centre, South Village Centre and The South Forest
    moving Allen from West Village Centre to Village Centre
    number of entries: 2

9:15 am

>wait
Time passes.

Joseph is moving 
    movement path:East Village Centre and Fishing House
    moving Joseph from Village Centre to East Village Centre
    number of entries: 1
Hope is moving 
    movement path:South Village Centre and The Common Shelf
    moving Hope from Village Centre to South Village Centre
    number of entries: 1
yourself is idle 
Melia is idle 
Tom is moving 
    movement path:Tavern Stable, West Village Centre, Village Centre, North Village Centre and Wheat Field
Tom says, "I really need to get going now."
Goat is idle 
Allen is moving 
    movement path:South Village Centre and The South Forest
    moving Allen from Village Centre to South Village Centre
    number of entries: 1

9:20 am

>wait
Time passes.

Joseph is moving 
    movement path:Fishing House
    moving Joseph from East Village Centre to Fishing House
    number of entries: 0
Hope is moving 
    movement path:The Common Shelf
    moving Hope from South Village Centre to The Common Shelf
    number of entries: 0
yourself is idle 
Melia is idle 
Tom is moving 
    movement path:Tavern Stable, West Village Centre, Village Centre, North Village Centre and Wheat Field
    moving Tom from The Common Area to Tavern Stable
    number of entries: 4
Goat is idle 
Allen is moving 
    movement path:The South Forest
    moving Allen from South Village Centre to The South Forest
    number of entries: 0

9:25 am

>wait
Time passes.

Joseph is idle 
Hope is idle 
yourself is idle 
Melia is idle 
Tom is moving 
    movement path:West Village Centre, Village Centre, North Village Centre and Wheat Field
    moving Tom from Tavern Stable to West Village Centre
    number of entries: 3
Goat is idle 
Allen is idle 

9:30 am

>wait
Time passes.

Joseph is idle 
Hope is idle 
yourself is idle 
Melia is idle 
Tom is moving 
    movement path:Village Centre, North Village Centre and Wheat Field
    moving Tom from West Village Centre to Village Centre
    number of entries: 2
Goat is idle 
Allen is idle 

9:35 am

>wait
Time passes.

Joseph is idle 
Hope is idle 
yourself is idle 
Melia is idle 
Tom is moving 
    movement path:North Village Centre and Wheat Field
    moving Tom from Village Centre to North Village Centre
    number of entries: 1
Goat is idle 
Allen is idle 

9:40 am

>wait
Time passes.

Joseph is idle 
Hope is idle 
yourself is idle 
Melia is idle 
Tom is moving 
    movement path:Wheat Field
    moving Tom from North Village Centre to Wheat Field
    number of entries: 0
Goat is idle 
Allen is idle 

9:45 am

>wait
Time passes.

Joseph is idle 
Hope is idle 
yourself is idle 
Melia is idle 
Tom is idle 
Goat is idle 
Allen is idle 

9:50 am

>wait
Time passes.

Joseph is idle 
Hope is idle 
yourself is idle 
Melia is idle 
Tom is idle 
Goat is idle 
Allen is idle 

9:55 am

>wait
Time passes.

Joseph is idle 
Hope is idle 
yourself is idle 
Melia is idle 
Tom is idle 
Goat is idle 
Allen is idle 

10:00 am

>wait
Time passes.

Joseph is idle 
Hope is idle 
yourself is idle 
Melia is idle 
Tom is idle 
Goat is idle 
Allen is idle 

10:05 am

>wait
Time passes.

Joseph is idle 
Hope is idle 
yourself is idle 
Melia is idle 
Tom is idle 
Goat is idle 
Allen is idle 

10:10 am

>wait
Time passes.

Joseph is idle 
Hope is idle 
yourself is idle 
Melia is idle 
Tom is idle 
Goat is idle 
Allen is idle 

10:15 am

>wait until 11:45
I only understood you as far as wanting to wait.

>wait 11:45am
I only understood you as far as wanting to wait.

>l
The Common Area
The tavern's main area, filled with tables and chairs. Villagers gather here to eat and talk.

You can see a Lodge Door, a Tavern Door and a Tavern Back Door here.

From here, you can go:
    north through the Tavern Back Door.
    south through the Lodge Door.
    east through the open Tavern Door to Tavern Stable.
    west to Taproom.

Joseph is idle 
Hope is idle 
yourself is idle 
Melia is idle 
Tom is idle 
Goat is idle 
Allen is idle 

10:20 am

* * *

You wake up to the sound of birds chirping outside your window. It's a peaceful morning in Clearhollow.

Lab 1
An Interactive Fiction by Cooper Mattern
Release 1 / Serial number 250420 / Inform 7 build 6M62 (I6/v6.33 lib 6/12N) SD

My House (on My Bed)
Your home is modest but comfortable, with a bed and a small table.

You can see a House Door here.

From here, you can go:
    north through the House Door.

>North
(first getting off My Bed)
(first opening the House Door)

My Yard
You can see a House Door, a Pen Door and a Yard Door here.

From here, you can go:
    north through the Yard Door.
    south through the House Door.
    west through the Pen Door.

* * *

You wake up to the sound of birds chirping outside your window. It's a peaceful morning in Clearhollow.

Lab 1
An Interactive Fiction by Cooper Mattern
Release 1 / Serial number 250420 / Inform 7 build 6M62 (I6/v6.33 lib 6/12N) SD

My House (on My Bed)
Your home is modest but comfortable, with a bed and a small table.

You can see a House Door here.

From here, you can go:
    north through the House Door.

>o house door
Sorry, that can't be corrected.

>open house door
You open the House Door.

>look
My House (on My Bed)
You can see a House Door here.

From here, you can go:
    north through the House Door.to My Yard

>look through the house door
You find nothing of interest.

>look
My House (on My Bed)
You can see a House Door here.

From here, you can go:
    north through the House Door.to My Yard

* * *

You wake up to the sound of birds chirping outside your window. It's a peaceful morning in Clearhollow.

Lab 1
An Interactive Fiction by Cooper Mattern
Release 1 / Serial number 250420 / Inform 7 build 6M62 (I6/v6.33 lib 6/12N) SD

My House (on My Bed)
Your home is modest but comfortable, with a bed and a small table.

You can see a House Door here.

From here, you can go:
    north through the House Door.

>open House Door
You open the House Door.

>l
My House (on My Bed)
You can see a House Door here.

From here, you can go:
    north through the open the House Door to My Yard.

* * *

You wake up to the sound of birds chirping outside your window. It's a peaceful morning in Clearhollow.

Lab 1
An Interactive Fiction by Cooper Mattern
Release 1 / Serial number 250420 / Inform 7 build 6M62 (I6/v6.33 lib 6/12N) SD

My House (on My Bed)
Your home is modest but comfortable, with a bed and a small table.

You can see a House Door here.

From here, you can go:
    north through the House Door.

>open door
You climb down from My Bed.

You open the House Door.

>l
My House (on My Bed)
You can see a House Door here.

From here, you can go:
    north through the open House Door to My Yard.

>get up
You get off My Bed.

My House
You can see a House Door and My Bed here.

From here, you can go:
    north through the open House Door to My Yard.

* * *

>open door
You climb down from My Bed.

You open the House Door.

>look
My House
You can see a House Door and My Bed here.

From here, you can go:
    north through the open House Door to My Yard.

>think
What a good idea.

>think
What a good idea.

* * *

You wake up to the sound of birds chirping outside your window. It's a peaceful morning in Clearhollow.

Lab 1
An Interactive Fiction by Cooper Mattern
Release 1 / Serial number 250420 / Inform 7 build 6M62 (I6/v6.33 lib 6/12N) SD

My House (on My Bed)
Your home is modest but comfortable, with a bed and a small table.

You can see a House Door here.

From here, you can go:
    north through the House Door.

>o door
Sorry, that can't be corrected.

* * *

>get off
You'll need to get off My Bed first.

>get off my bed
You'll need to get off My Bed first.

* * *

>open door
You climb down from My Bed.

You open the House Door.

>l
My House
You can see a House Door and My Bed here.

From here, you can go:
    north through the open House Door to My Yard.

>n
My Yard
You can see a House Door, a Pen Door and a Yard Door here.

From here, you can go:
    north through the Yard Door.
    south through the open House Door to My House.
    west through the Pen Door.

>s
My House
You can see a House Door and My Bed here.

From here, you can go:
    north through the open House Door to My Yard.

>n
My Yard
You can see a House Door, a Pen Door and a Yard Door here.

From here, you can go:
    north through the Yard Door.
    south through the open House Door to My House.
    west through the Pen Door.

>close door
Which do you mean, the House Door, the Pen Door or the Yard Door?

>close the house door
You close the House Door.

>l
My Yard
You can see a House Door, a Pen Door and a Yard Door here.

From here, you can go:
    north through the Yard Door.
    south through the House Door.
    west through the Pen Door.

>w
(first opening the Pen Door)

My Goat Pen
You can see a Pen Door here.

From here, you can go:
    east through the open Pen Door to My Yard.

>e
My Yard
You can see a Pen Door, a House Door and a Yard Door here.

From here, you can go:
    north through the Yard Door.
    south through the House Door.
    west through the open Pen Door to My Goat Pen.

>close pen door
You close the Pen Door.

>l
My Yard
You can see a Pen Door, a House Door and a Yard Door here.

From here, you can go:
    north through the Yard Door.
    south through the House Door.
    west through the Pen Door.

>exit
But you aren't in anything at the moment.

>exits
That's not a verb I recognise.

>where
That's not a verb I recognise.

>n
(first opening the Yard Door)

West Village Centre
You can see a Yard Door here.

From here, you can go:
     north to Tavern Stable.
    south through the open Yard Door to My Yard.
     east to Village Centre.
     west to West Forest.

>close yard door
You close the Yard Door.

>ls
That's not a verb I recognise.

>w
If your goat went in there, it's long gone. Let's keep looking around the village.

>n
Tavern Stable
You can see a Tavern Door here.

From here, you can go:
     south to West Village Centre.
    west through the Tavern Door.

* * *

>w
(first opening the Tavern Door)

The Common Area
You can see a Lodge Door, a Tavern Door and a Tavern Back Door here.

From here, you can go:
    north through the Tavern Back Door.
    south through the Lodge Door.
    east through the open Tavern Door to Tavern Stable.
     west to Taproom.

>n
(first opening the Tavern Back Door)

North Forest
You can see a Tavern Back Door here.

There are no obvious exits from here.

>look
North Forest
You can see a Tavern Back Door here.

There are no obvious exits from here.